.....*..
.**.....
.....*..
.GS*....
*..*...*
*.*..*..
....*...
........
