......*..
.......G.
....*..*.
....*....
...*.....
.........
...S.....
.........
